Acadia National Park	(BHB, BOS)
Amsterdam (AMS)
Anchorage	(ANC)
Aruba Island	(AUA)
Athens	(ATH)
Auckland	(AKL)
Bali	(DPS)
Barcelona	(BCN)
Beijing	(PEK)
Berlin	(BER)
Big Sur	(MRY, SJC, SFO)
Boston	(BOS)
Breckenridge	(EGE, DEN)
Buenos Aires	(EZE)
Cabo San Lucas	(SJD)
Cairo	(CAI)
Cancun	(CUN)
Cape Town	(CPT)
Charleston	(CHS)
Charlotte	(CLT)
Chicago	(ORD, MDW)
Copenhagen	(CPH)
Custer State Park	(RAP)
Denver	(DEN)
Dubai	(DXB)
Dublin	(DUB)
Edinburgh	(EDI)
Glacier National Park	(FCA)
Grand Canyon	(FLG, LAS)
Great Smoky Mountains National Park	(TYS, AVL)
Hanoi	(HAN)
Hong Kong	(HKG)
Houston	(IAH)
Istanbul	(IST)
Jackson Hole	(JAC)
Jerusalem	(TLV)
Key West	(EYW)
Lake Tahoe	(RNO, TVL)
Las Vegas	(LAS)
Lima	(LIM)
London	(LHR)
Los Angeles	(LAX)
Mackinac Island	(MCD, PLN)
Madrid	(MAD)
Maui	(OGG)
Mexico City	(MEX)
Miami	(MIA)
Montego Bay	(MBJ)
Montreal	(YUL)
Mount Rushmore	(RAP)
Mumbai	(BOM)
Myrtle Beach	(MYR)
Napa Valley	(SFO, OAK, SMF)
Nashville (BNA)
New Orleans	(MSY)
New York	(JFK, LGA, EWR)
Orlando	(MCO)
Oslo	(OSL)
Panama City	(PTY)
Paris	(CDG)
Philadelphia	(PHL)
Phuket	(HKT)
Prague	(PRG)
Reykjavik	(KEF)
Rio de Janeiro	(GIG)
Rome	(FCO)
San Francisco	(SFO)
San Juan	(SJU)
Santa Fe	(SAF, ABQ)
Santiago	(SCL)
Savannah	(SAV)
Seattle (SEA)
Seoul	(ICN)
Shanghai	(PVG)
Singapore	(SIN)
Split	(SPU)
St. Augustine	(JAX, SFB)
Stockholm	(ARN)
Sydney	(SYD)
Tampa	(TPA)
Telluride	(MTJ, DRO)
Tokyo	(NRT, HND)
Toronto	(YYZ)
Vancouver	(YVR)
Vienna	(VIE)
Washington DC	(IAD, DCA)
Yellowstone National Park	(BOZ, JAC)
Yosemite National Park	(FAT, SJC)
Zion National Park	(SGU, LAS)
Zurich	(ZRH)
